##################################################
#................................................#
#................................................#
#................................................#
#................................................#
#................................................#
#................................................#
#................................................#
#................................................#
#................................................#
#..........-------------------------------.......#
#................................................#
#................................................#
#..............................@.................#
#................................................#
#................................................#
#..........-----------------------------.........#
#................................................#
#................................................#
#................................................#
#................................................#
#....@......@....................................#
#######################..........................#
#................................................#
#................................................#
#................................................#
#................................................#
#................................................#
#................................................#
#.......................@.......@................#
#....................#####################.......#
#................................................#
#................................................#
#................................................#
#................................................#
#................................................#
#................................................#
#................................................#
#................................................#
#................................................#
#............@...................................#
#......################..........................#
#................................................#
#................................................#
#................................................#
#................................................#
#...........................+....................#
#................................................#
##################################################
##################################################